NO ./image/wood.xpm
SO ./image/bluestone.xpm
WE ./image/eagle.xpm
EA      ./image/redbrick.xpm

F 25,10,100
C 225,3,111


        1111111111111111111111111
        1000000000110000000000001
        1011000001110000000000001
        1001000000000000000000001
111111111011000001110000000000001
100000000011000001110111111111111
11110111111111011100000010001
11110111111111011101010010001
110000001101010111000000100011
100000000000000011000000100001
100000000000000011010100100011
11000001110101011111011110N0111
11110111 1110101 101111010001
11111111 1111111 111111111111
