

NO ./image/wood.xpm



SO ./image/bluestone.xpm
F 0,255,0

WE ./image/eagle.xpm



EA      ./image/redbrick.xpm

C 0,0,255


1111111111111111111111111
1S00000000110000000000001
1011000001110000000000001
1001000000000000000000001111111111111111111111111
1111111111111111100000001011000001110000000000001
                100000000011000001110111111111111
                11110111111111011100000010001
                11110111111111011101010000001   111
                110000001101010111000000100011  101
                100000000000000000000000100001  111
                100000000000000011010100100011
                110000011101010111110111100111
                11110111 1110101 101111010001
                11111111 1111111 111111111111
